T T T T T T T T T T T T T T T T T T T
T B B B B T B B B B B B B T B B B B T
T L T T B T B T T T T T B T B T T L T
T B B T B B B B B T B B B B B T B B T
T T B T B T B T B T B T B T B T B T T
N N B B B T B T B T B T B T B B B N N
T T B T B T B T B B B T B T B T B T T
N T B T B T B T T T T T B T B T B T N
T T B T B B N N N N N N N B B T B T T
T B B B B T N T N T 4 T N T B B B B T
T T B T T T N T 1 2 3 T N T T T B T T
T B B B B T N T T T T T N T B B B B T
T B T T B T N N N N N N N T B T T B T
T B B T B T B T T T T T B T B T B B T
T T B T B T B B B T B B B T B T B T T
N N B B B B B T B P B T B B B B B N N
T T B T B T T T B T B T T T B T B T T
T B B T B B B B B T B B B B B T B B T
T L T T B T B T T T T T B T B T T L T
T B B B B T B B B B B B B T B B B B T
T T T T T T T T T T T T T T T T T T T